NO                         ./textures/exit.xpm


WE                                                ./textures/phinn.xpm


SO                                   ./textures/floor.xpm
EA                                                         ./textures/coin.xpm


F    213 , 45 , 60 
C    225,                  123,                                                         112


111111111111111111111111
100011001100110000000111111
10111111111000000000000001
10010000001000000000000011111111                      1111                        
111111111011000001110000000000001                                              
100000000000000111110110111111111                                   
11110111111111111100000010001
11110111111111111101010010001
11000000111101111100000010001
1000000010N100000000000000011  
10000000101100001101010010001      
1000000111010101110101111000111  
1011011111110101110111110001
10111111111111111111111111111
101
111
